1111111111118
1000630111218
1011110001018
1031530103018
1101111111118
1000001030118
1401131610118
1101100010318
1101111110118
1303511110118
1411117000318
11111111111189