111111118
131131718
100000018
110111118
100100218
131101018
100000018
1111111189