11111111111111118
10000011000110718
10111011010030118
10031000010101118
10111011010001118
10000011011111118
11111110000311118
10000011111003018
13101310301111018
10001010100103018
11131010113101118
10301010010130118
10111011010110018
10110001310011318
12100000010000018
111111111111111189